anniversaries	ANIVS
birthdays	ANIVS
anniversary	ANIV
birthday	ANIV
sunday	DOW	0
monday	DOW	1
tuesday	DOW	2
wednesday	DOW	3
thursday	DOW	4
friday	DOW	5
saturday	DOW	6
sun	DOWA DOW	0
mon	DOWA DOW	1
tues	DOWA DOW	2
tue	DOWA DOW	2
weds	DOWA DOW	3
wed	DOWA DOW	3
thurs	DOWA DOW	4
thur	DOWA DOW	4
fri	DOWA DOW	5
sat	DOWA DOW	6
january	MON MS	1
february	MON MS	2
march	MON MAMB	3
april	MON MAMB	4
may	MON MAMB	5
june	MON MAMB	6
july	MON MS	7
august	MON MAMB	8
september	MON MS	9
october	MON MS	10
november	MON MS	11
december	MON MS	12
jan	MONA MS	1
feb	MONA MS	2
mar	MONA	3
apr	MONA	4
jun	MONA	6
jul	MONA MS	7
aug	MONA	8
sept	MONA MS	9
sep	MONA MS	9
oct	MONA MS	10
nov	MONA MS	11
dec	MONA MS	12
spring	SEA	SP
springtime	SEA SEAS	SP
spring-time	SEA SEAS	SP
spring time ::	SEA SEAS	SP
summer	SEA SEAS	SU
summertime	SEA SEAS	SU
summer-time	SEA SEAS	SU
summer time ::	SEA SEAS	SU
fall	SEA	FA
autumn	SEA SEAS	FA
autumntime	SEA SEAS	FA
autumn-time	SEA SEAS	FA
autumn time ::	SEA SEAS	FA
winter	SEA SEAS	WI
wintertime	SEA SEAS	WI
winter-time	SEA SEAS	WI
winter time ::	SEA SEAS	WI
twenties	DEC	20
thirties	DEC	30
forties	DEC	40
fifties	DEC	50
sixties	DEC	60
seventies	DEC	70
eighties	DEC	80
nineties	DEC	90
day	DU	D
week	DU	W
month	DU	M
season	DU	SE
quarter	DU	Q
year	DU YEAR	Y
decade	DU	E
century	DU	C
millennium	DU	L
era	DU	L
days	DUP	D
weekends	DUP	WE
weeks	DUP	W
months	DUP	M
seasons	DUP	SE
quarters	DUP	Q
years	DUP	Y
decades	DUP	E
centuries	DUP	C
millenniums	DUP	L
eras	DUP	L
hourly	REP	H
daily	REP	D
weekly	REP	W
monthly	REP	M
yearly	REP	Y
annual	REP	Y
annually	REP	Y
every	REP_SIG
each and every	REP_SIG
each	REP_SIG
per	REP_SIG
more than ::	POINT_MOD	BEFORE
less than ::	POINT_MOD	AFTER
no less than ::	POINT_MOD	ON_OR_BEFORE
no more than ::	POINT_MOD	ON_OR_AFTER
some	POINT_MOD QUANT	APPROX
about	POINT_MOD	APPROX
around	POINT_MOD	APPROX
approximately	POINT_MOD	APPROX
almost	POINT_MOD	APPROX
less than ::	DUR_MOD	LESS_THAN
nearly	DUR_MOD	LESS_THAN
more than ::	DUR_MOD	MORE_THAN
no more than ::	DUR_MOD	EQUAL_OR_LESS
at least ::	DUR_MOD	EQUAL_OR_MORE
about	DUR_MOD	APPROX
around	DUR_MOD	APPROX
almost	DUR_MOD	APPROX
approximately	DUR_MOD	APPROX
alone	POST_POINT_MOD
at a time ::	POST_DUR_MOD
on end ::	POST_DUR_MOD
in a row ::	POST_DUR_MOD
second	TU	S
minute	TU	MIN
hour	TU TUN	H
half-hour	TU	30MIN
half - hour ::	TU	30MIN
half an hour ::	TU	30MIN
seconds	TUP	S
minutes	TUP	MIN
hours	TUP	H
morning	DP	MO
sunup	DP	MO
afternoon	DP	AF
evening	DP	EV
eve	DP	EV
night	DP	NI
overnight	DP	NI
mornings	DPP	MO
afternoons	DPP	AF
evenings	DPP	EV
nights	DPP	NI
weekend	DN	WE
tonight	TN	NI
noon	TN	MI
midday	TN	MI
mid-day	TN	MI
mid - day :: TN	MI
midnight	TN	NI
midafternoon	TN	AF
daylight	TN	DT
daylight hours :: TN	DT
day time :: TN	DT
daytime TN  DT
late-night	TN	NI
late-night hours :: TN	NI
late - night	:: TN	NI
late - night hours :: TN	NI
pre-dawn	TN	NI
pre-dawn hours :: TN	NI
pre - dawn	:: TN	NI
pre - dawn hours :: TN	NI
this moment	:: PPF	PRESENT_REF
this very moment	:: PPF	PRESENT_REF
this very second	:: PPF	PRESENT_REF
this very minute	:: PPF	PRESENT_REF
the present time	:: PPF	PRESENT_REF
the present moment	:: PPF	PRESENT_REF
now	:: PPF NOW	PRESENT_REF
right now	:: PPF	PRESENT_REF
nowadays	:: PPF	PRESENT_REF
current	:: PPF	PRESENT_REF
currently	:: PPF	PRESENT_REF
present	:: PPF	PRESENT_REF
presently	:: PPF	PRESENT_REF
this time	:: PPF	PRESENT_REF
this point in time	:: PPF	PRESENT_REF
future	PPF	FUTURE_REF
past	PPF	PAST_REF
former	PPF	PAST_REF
ex	PPF	PAST_REF
lately	PPF	PAST_REF
recent	PPF	PAST_REF
onetime	PPF	PAST_REF
recently	PPF	PAST_REF
formerly	PPF	PAST_REF
previously	PPF	PAST_REF
long ago	:: PPF	PAST_REF
a long time ago	:: PPF	PAST_REF
long time ago	:: PPF	PAST_REF
some time ago	:: PPF	PAST_REF
an earlier time	:: PPF	PAST_REF
medieval	:: PPF	PAST_REF
last	LN	predecessor
next	LN	successor
this	LN ANAPH
that	LN ANAPH THAT
the same	:: LN ANAPH
past	FP	predecessor
last	FP	predecessor
next	FP	successor
coming	FP	successor
following	FP	successor
to come	:: FP	successor
to go	:: FP	successor
previous	FP	predecessor
end	EW	END
turn	EW	END
beginning	EW	START
start	EW	START
dawn	EW	START
middle	EW	MID
all	EW
late	LE	END
later	LE	END
early	LE	START
earlier	LE	START
sunrise	LE	START
mid	LE	MID
later	LER	successor
ago	LER	predecessor
earlier	LER	predecessor
before	BA	predecessor
after	BA	successor
today	DD	D
yesterday	DD	predecessor(D)
tomorrow	DD	successor(D)
in	PREP
by	PREP
during	PREP
before	PREP
after	PREP
throughout	PREP
through	PREP
until	PREP
since	PREP
on	PREP ON
at	PREP AT
over	PREP
from	PREP FROM
for	PREP FOR
within	PREP
as early as :: PREP
the	THE DET
of	OF
or	OR
to	TO
before	TO
till	TO
after	PAST
past	PAST
time	TIME
times	TIMES
preseason	VAGUE
pre-season	VAGUE
term	VAGUE
period	VAGUE
age	VAGUE
then	THEN
a	AANONE DET
an	AANONE DET
one	AANONE
all	AANONE DET
much	MUCHMORE
more	MUCHMORE
his	DET PERSPRON
her	DET PERSPRON
their	DET PERSPRON
our	DET PERSPRON
my	DET PERSPRON
your	DET PERSPRON
its	DET
and	AND CONJ
but	CONJ
or	CONJ
long	LONG
old	LONG
very	VERY
nearly	NRLY
about	NRLY
approximately	NRLY
more than :: NRLY
less than :: NRLY
fiscal	FINANCIAL
FY	FINANCIAL
tax	FINANCIAL
financial	FINANCIAL
several	QUANT
many	QUANT
few	QUANT
enough	QUANT
a few :: QUANT
a matter of :: QUANT
quite a bit of :: QUANT
number of :: QUANT
quite a few :: QUANT
tens of :: QUANT
dozens of :: QUANT
hundreds of :: QUANT
thousands of :: QUANT
millions of :: QUANT
billions of :: QUANT
holiday	HOLIDAY
Adventszeit	HOL
Basanth	HOL
Bolludagur	HOL
Candelora	HOL
Chanuka	HOL
Christabend	HOL
Christmas	HOL
Cuaresma	HOL
Deepavali	HOL
Deepawali	HOL
Dwali	HOL
Diwali	HOL
Easter	HOL
Easter Sunday ::	HOL
Eid-al-Adha	HOL
Eid - al-Adha ::	HOL
Eid-al - Adha ::	HOL
Eid - al - Adha ::	HOL
Eid-ul-Fitr	HOL
Eid - ul-Fitr ::	HOL
Eid-ul - Fitr ::	HOL
Eid - ul - Fitr ::	HOL
Epiphany	HOL
Fastelavnstirsdag	HOL
Gamlarskvold	HOL
Ganjitsu	HOL
Happy Ramadan	:: HOL
Halloween	HOL
Hannukah	HOL
Hanucha	HOL
Hanukkah	HOL
Hinamatsuri	HOL
Hogmanay	HOL
Holi	HOL
Husbandday	HOL
Hvitasunnudagur	HOL
Jolakottur	HOL
Jolasveinar	HOL
Julafton	HOL
Juleaften	HOL
Juletide	HOL
Jultomten	HOL
Kawanza	HOL
Lent	HOL
Navidad	HOL
Nikolaustag	HOL
Nowrouz	HOL
Nyarsdagur	HOL
Nytar	HOL
Nytarsaften	HOL
Nyttaarsaften	HOL
O-misuka	HOL
O-sho-ga-tsu	HOL
O - sho-ga-tsu ::	HOL
O-sho - ga-tsu ::	HOL
O-sho-ga - tsu ::	HOL
O-sho - ga - tsu ::	HOL
O - sho - ga - tsu ::	HOL
Obon	HOL
Oudjaarsavond	HOL
Paskadagur	HOL
Paske	HOL
Passover	HOL
Pentecost	HOL
Pesach	HOL
Purim	HOL
Ramadan	HOL
Seijin-no-hi	HOL
Seijin - no-hi ::	HOL
Seijin-no - hi ::	HOL
Seijin - no - hi ::	HOL
Setsubun	HOL
Seven-Five-Three	HOL
Seven - Five - Three ::	HOL
Shavout	HOL
Sham al-Naseem ::	HOL
Sham al- Naseem ::	HOL
Sham al - Naseem ::	HOL
Sham al -Naseem ::	HOL
Shichi-go-san	HOL
Shichi - go-san ::	HOL
Shichi-go - san ::	HOL
Shichi - go - san ::	HOL
Sinterklaas	HOL
Sprengidagur	HOL
Succot	HOL
Tanabata	HOL
Tet	HOL
Thaipusam	HOL
Thanksgiving	HOL
Threttandinn	HOL
Tu-Bi'Shvat	HOL
Tu-Bi 'Shvat ::	HOL
Tu-Bi'shvat	HOL
Tu-Bi 'shvat ::	HOL
Undoukai	HOL
Uppstigningardagur	HOL
Valborgsma"ssoafton	HOL
Vappu	HOL
Weihnachtszeit	HOL
Whitsunday	HOL
a"idinpa"iva"	HOL
itsena"isyyspa"iva"	HOL
laskiaistiistai	HOL
palmusunnuntai	HOL
Advent Time :: HOL
All Saints' Day ::	HOL
All Saints ' Day ::	HOL
All Souls' Day ::	HOL
All Souls ' Day ::	HOL
Anzac Day ::	HOL
An~o Nuevo ::	HOL
April Fools Day ::	HOL
Armed Forces Day ::	HOL
Ascension Day ::	HOL
Ash Wednesday ::	HOL
Australia Day ::	HOL
Batalla de las Piedras ::	HOL
Bonfire Day ::	HOL
Boxing Day ::	HOL
Boys' Day ::	HOL
Boys ' Day ::	HOL
Bozicni vecer ::	HOL
Burns Night ::	HOL
Camberra Day ::	HOL
Candelmas Day ::	HOL
Charro Days ::	HOL
Christmas Day ::	HOL
Christmas Eve ::	HOL
Christmas Time ::	HOL
Cinco de Mayo ::	HOL
Columbus Day ::	HOL
Combate de Angamos ::	HOL
Coming-of-Age Day ::	HOL
Constitution Day ::	HOL
Constitution Memorial Day ::	HOL
Corpus Christi ::	HOL
Culture Day ::	HOL
Dagur nemenda ::	HOL
Desembarco de los 33 Orientales ::	HOL
Dia de Resureccion ::	HOL
Dia de Todos los Santos ::	HOL
Dia de la Madre ::	HOL
Dia del Trabajo ::	HOL
Dragon Boat Festival ::	HOL
Earth Day ::	HOL
Eid El-Fetr ::	HOL
Eid Festival ::	HOL
El Valentin ::	HOL
Election Day ::	HOL
Emperor's Birth Day ::	HOL
Emperor 's Birth Day ::	HOL
Fat Thursday ::	HOL
Fat Tuesday ::	HOL
Father's Day ::	HOL
Father 's Day ::	HOL
Festival of Souls ::	HOL
Flag Day ::	HOL
Foundation Day ::	HOL
Fourth of July ::	HOL
Fyrsti mai ::	HOL
Girls' Day ::	HOL
Girls ' Day ::	HOL
Golden Week ::	HOL
Good Friday ::	HOL
Green Day ::	HOL
Ground Hog Day ::	HOL
Groundhog Day ::	HOL
Guy Fawkes Night ::	HOL
Hari Kebangsaan ::	HOL
Hari Raya Haji ::	HOL
Hari Raya Puasa ::	HOL
Health Sports Day ::	HOL
Holy Week ::	HOL
Immaculate Conception ::	HOL
Independance Day ::	HOL
Independence Day ::	HOL
Inti Raymi ::	HOL
Jose Gervasio Artigas ::	HOL
Kenkoku Kenen-no-hi ::	HOL
La Purisima ::	HOL
Labor Day ::	HOL
Labour Day ::	HOL
Labour day ::	HOL
Li Chum ::	HOL
Liberation Day ::	HOL
Lincoln's Birthday ::	HOL
Lincoln 's Birthday ::	HOL
Lunar New Year ::	HOL
Mamacha Candicha ::	HOL
Mardi Gras ::	HOL
Martin Luther King Day ::	HOL
Maryland Day ::	HOL
Melbourne Cup ::	HOL
Mem. Day Holocaust ::	HOL
Mem. Day Soldiers ::	HOL
Memorial Day ::	HOL
Midsummer Night ::	HOL
Mother's Day ::	HOL
Mother 's Day ::	HOL
National Day ::	HOL
National Pig Day ::	HOL
Native American Day ::	HOL
New Year's Day ::	HOL
New Year 's Day ::	HOL
New Year's Eve ::	HOL
New Year 's Eve ::	HOL
New Year ::	HOL
Noche Buena ::	HOL
Novo leto ::	HOL
Palm Sunday ::	HOL
Patriot's Day ::	HOL
Patriot 's Day ::	HOL
Pioneer Day ::	HOL
Ponggal-Harvest Festival ::	HOL
Ponggal - Harvest Festival ::	HOL
President's Day ::	HOL
President 's Day ::	HOL
Prophet Mohamed's birthday ::	HOL
Prophet Mohamed 's birthday ::	HOL
Pupils' Day ::	HOL
Pupils ' Day ::	HOL
Queen's Birthday ::	HOL
Queen 's Birthday ::	HOL
Quema del Diablo ::	HOL
Red Nose Day ::	HOL
Remembrance of the Deaths ::	HOL
Respect-for-the-Aged Day ::	HOL
Robert Burns Night ::	HOL
Rosh Hashana ::	HOL
Rosh Hashanah ::	HOL
S. Valentino ::	HOL
San Pedro Y San Pablo ::	HOL
San Sebastian ::	HOL
San Valentin ::	HOL
Santa Rosa de Lima ::	HOL
Semana Santa ::	HOL
Shrove Tuesday ::	HOL
Sint Maarten ::	HOL
St. David's Day ::	HOL
St. David 's Day ::	HOL
St. Francis of Assisi ::	HOL
St. Hans Aften ::	HOL
St. Lucia ::	HOL
St. Martinus ::	HOL
St. Nicholas ::	HOL
St. Patrick's Day ::	HOL
St. Patrick 's Day ::	HOL
St. Sebastian ::	HOL
Star Festival ::	HOL
Sumardagurinn fyrsti ::	HOL
Tango no sekku ::	HOL
Teachers' Day ::	HOL
Teachers ' Day ::	HOL
The Lantern Festival ::	HOL
The Merry Monarch Festival ::	HOL
Valentine's Day ::	HOL
Valentine 's Day ::	HOL
Vernal Equinox ::	HOL
Veterans Day ::	HOL
Victoria Day ::	HOL
Victory Day ::	HOL
Waitangi Day ::	HOL
Walpurgis Night ::	HOL
Washington's Birthday ::	HOL
Washington 's Birthday ::	HOL
Wesak Day ::	HOL
Wilayah Persekutuan ::	HOL
Woman's Day ::	HOL
Woman 's Day ::	HOL
Yom Ha'Shoa ::	HOL
Yom Ha 'Shoa ::	HOL
Yom Ha'Zikaron ::	HOL
Yom Ha 'Zikaron ::	HOL
Yom Ha'zmaut ::	HOL
Yom Ha 'zmaut ::	HOL
Yom Kippur ::	HOL
one	UNIT	1
two	UNIT	2
three	UNIT	3
four	UNIT	4
five	UNIT	5
six	UNIT	6
seven	UNIT	7
eight	UNIT	8
nine	UNIT	9
ten	TEEN	10
eleven	TEEN	11
twelve	TEEN	12
thirteen	TEEN	13
fourteen	TEEN	14
fifteen	TEEN	15
sixteen	TEEN	16
seventeen	TEEN	17
eighteen	TEEN	18
nineteen	TEEN	19
twenty	TY	20
thirty	TY	30
forty	TY	40
fifty	TY	50
sixty	TY	60
seventy	TY	70
eighty	TY	80
ninety	TY	90
half	PART	HALF
part	PART	HALF
third	PART	THIRD
quarter	PART	Q
halfs	PARTP	HALF
halves	PARTP	HALF
thirds	PARTP	THIRD
quarters	PARTP	Q
first	UNITH ORD	1
second	UNITH ORD	2
third	UNITH ORD	3
fourth	UNITH ORD	4
fifth	UNITH ORD	5
sixth	UNITH ORD	6
seventh	UNITH ORD	7
eighth	UNITH ORD	8
ninth	UNITH ORD	9
tenth	TEENTH ORD	10
eleventh	TEENTH ORD	11
twelfth	TEENTH ORD	12
thirteenth	TEENTH ORD	13
fourteenth	TEENTH ORD	14
fifteenth	TEENTH ORD	15
sixteenth	TEENTH ORD	16
seventeenth	TEENTH ORD	17
eighteenth	TEENTH ORD	18
nineteenth	TEENTH ORD	19
twentieth	TIETH ORD	20
thirtieth	TIETH ORD	30
fortieth	TIETH ORD	40
fiftieth	TIETH ORD	50
sixtieth	TIETH ORD	60
seventieth	TIETH ORD	70
eightieth	TIETH ORD	80
ninetieth	TIETH ORD	90
Alpha Time ::	TIMEZONEFULL	+01
ACDT	TIMEZONE	+10:30
Australian Central Daylight Time ::	TIMEZONEFULL	+10:30
ACST	TIMEZONE	+09:30
Australian Central Standard Time ::	TIMEZONEFULL	+09:30
ADT	TIMEZONE	-03
Atlantic Daylight Time ::	TIMEZONEFULL	-03
AEDT	TIMEZONE	+11
Australian Eastern Daylight Time ::	TIMEZONEFULL	+11
Australian Eastern Summer Time ::	TIMEZONEFULL	+11
AEST	TIMEZONE	+10
Australian Eastern Standard Time ::	TIMEZONEFULL	+10
AKDT	TIMEZONE	-08
Alaska Daylight Time ::	TIMEZONEFULL	-08
AKST	TIMEZONE	-09
Alaska Standard Time ::	TIMEZONEFULL	-09
AKT	TIMEZONE	-09
Alaska Time ::	TIMEZONEFULL	-09
AST	TIMEZONE	-04
Atlantic Standard Time ::	TIMEZONEFULL	-04
AWDT	TIMEZONE	+09
Australian Western Daylight Time ::	TIMEZONEFULL	+09
AWST	TIMEZONE	+08
Australian Western Standard Time ::	TIMEZONEFULL	+08
AT	TIMEZONE	-04
Atlantic Time ::	TIMEZONEFULL	-04
Bravo Time ::	TIMEZONEFULL	+02
BST	TIMEZONE	+01
British Summer Time ::	TIMEZONEFULL	+01
Charlie Time ::	TIMEZONEFULL	+03
CDT	TIMEZONE	+10:30
Central Daylight Time ::	TIMEZONEFULL	+10:30
CDT	TIMEZONE	-05
Central Daylight Time ::	TIMEZONEFULL	-05
CEDT	TIMEZONE	+02
Central European Daylight Time ::	TIMEZONEFULL	+02
CEST	TIMEZONE	+02
Central European Summer Time	+02
CET	TIMEZONE	+01
Central European Time ::	TIMEZONEFULL	+01
CST	TIMEZONE	+10:30
Central Summer Time ::	TIMEZONEFULL	+10:30
CST	TIMEZONE	+09:30
Central Standard Time ::	TIMEZONEFULL	+09:30
CST	TIMEZONE	-06
Central Standard Time ::	TIMEZONEFULL	-06
CXT	TIMEZONE	+07
Christmas Island Time ::	TIMEZONEFULL	+07
CT	TIMEZONE	-06
North American Central Time ::	TIMEZONEFULL	-06
Central Time ::	TIMEZONEFULL	-06
Delta Time ::	TIMEZONEFULL	+04
Echo Time ::	TIMEZONEFULL	+05
EDT	TIMEZONE	+11
Eastern Daylight Time ::	TIMEZONEFULL	+11
EDT	TIMEZONE	-04
Eastern Daylight Time ::	TIMEZONEFULL	-04
EEDT	TIMEZONE	+03
Eastern European Daylight Time ::	TIMEZONEFULL	+03
EEST	TIMEZONE	+03
Eastern European Summer Time ::	TIMEZONEFULL	+03
EET	TIMEZONE	+02
Eastern European Time ::	TIMEZONEFULL	+02
EST	TIMEZONE	+11
Eastern Summer Time ::	TIMEZONEFULL	+11
EST	TIMEZONE	+10
Eastern Standard Time ::	TIMEZONEFULL	+10
EST	TIMEZONE	-05
Eastern Standard Time ::	TIMEZONEFULL	-05
ET	TIMEZONE	-05
North American Eastern Time ::	TIMEZONEFULL	-05
Eastern Time ::	TIMEZONEFULL	-05
GMT	TIMEZONE
gmt	TIMEZONE
Greenwich Mean Time ::	TIMEZONEFULL
HAA	TIMEZONE	-03
Heure Avanc�e de l'Atlantique ::	TIMEZONEFULL	-03
HAC	TIMEZONE	-05
Heure Avanc�e du Centre ::	TIMEZONEFULL	-05
HADT	TIMEZONE	-09
Hawaii-Aleutian Daylight Time ::	TIMEZONEFULL	-09
HAE	TIMEZONE	-04
Heure Avanc�e de l'Est ::	TIMEZONEFULL	-04
HAP	TIMEZONE	-07
Heure Avanc�e du Pacifique ::	TIMEZONEFULL	-07
HAR	TIMEZONE	-06
Heure Avanc�e des Rocheuses ::	TIMEZONEFULL	-06
HAST	TIMEZONE	-10
Hawaii-Aleutian Standard Time ::	TIMEZONEFULL	-10
HAT	TIMEZONE	-02:30
Heure Avanc�e de Terre-Neuve ::	TIMEZONEFULL	-02:30
HAY	TIMEZONE	-08
Heure Avanc�e du Yukon ::	TIMEZONEFULL	-08
HNA	TIMEZONE	-04
Heure Normale de l'Atlantique ::	TIMEZONEFULL	-04
HNC	TIMEZONE	-06
Heure Normale du Centre ::	TIMEZONEFULL	-06
HNE	TIMEZONE	-05
Heure Normale de l'Est ::	TIMEZONEFULL	-05
HNP	TIMEZONE	-08
Heure Normale du Pacifique ::	TIMEZONEFULL	-08
HNR	TIMEZONE	-07
Heure Normale des Rocheuses ::	TIMEZONEFULL	-07
HNT	TIMEZONE	-03:30
Heure Normale de Terre-Neuve ::	TIMEZONEFULL	-03:30
HNY	TIMEZONE	-09
Heure Normale du Yukon ::	TIMEZONEFULL	-09
HT	TIMEZONE	-10
Hawaii-Aleutian Time ::	TIMEZONEFULL	-10
Indian Standard Time	+05:30
IST	TIMEZONE	+01
Irish Summer Time ::	TIMEZONEFULL	+01
JST	TIMEZONE	+09
Japan Standard Time ::	TIMEZONEFULL	+09
Kilo Time ::	TIMEZONEFULL	+10
KST	TIMEZONE	+09
Korea Standard Time ::	TIMEZONEFULL	+09
Lima Time ::	TIMEZONEFULL	+11
Mike Time ::	TIMEZONEFULL	+12
MDT	TIMEZONE	-06
Mountain Daylight Time ::	TIMEZONEFULL	-06
MESZ	TIMEZONE	+02
Mitteleuro�ische Sommerzeit ::	TIMEZONEFULL	+02
MEZ	TIMEZONE	+01
Mitteleurop�ische Zeit ::	TIMEZONEFULL	+01
MSD	TIMEZONE	+04
Moscow Daylight Time ::	TIMEZONEFULL	+04
MSK	TIMEZONE	+03
Moscow Standard Time ::	TIMEZONEFULL	+03
MST	TIMEZONE	-07
Mountain Standard Time ::	TIMEZONEFULL	-07
MT	TIMEZONE	-07
Mountain Time ::	TIMEZONEFULL	-07
November Time ::	TIMEZONEFULL	-01
NDT	TIMEZONE	-02:30
Newfoundland Daylight Time ::	TIMEZONEFULL	-02:30
NFT	TIMEZONE	+11:30
Norfolk Island Time ::	TIMEZONEFULL	+11:30
Norfolk Time ::	TIMEZONEFULL	+11:30
NST	TIMEZONE	-03:30
Newfoundland Standard Time ::	TIMEZONEFULL	-03:30
Oscar Time ::	TIMEZONEFULL	-02
Papa Time ::	TIMEZONEFULL	-03
PDT	TIMEZONE	-07
Pacific Daylight Time ::	TIMEZONEFULL	-07
PST	TIMEZONE	-08
Pacific Standard Time ::	TIMEZONEFULL	-08
PT	TIMEZONE	-08
Pacific Time ::	TIMEZONEFULL	-08
Quebec Time ::	TIMEZONEFULL	-04
Romeo Time ::	TIMEZONEFULL	-05
Sierra Time ::	TIMEZONEFULL	-06
SAST	TIMEZONE	+02
South Africa Standard Time ::	TIMEZONEFULL	02
Tango Time ::	TIMEZONEFULL	-07
Uniform Time ::	TIMEZONEFULL	-08
UTC	TIMEZONE
Coordinated Universal Time ::	TIMEZONEFULL
Victor Time ::	TIMEZONEFULL	-09
Whiskey Time ::	TIMEZONEFULL	-10
WDT	TIMEZONE	+09
Western Daylight Time ::	TIMEZONEFULL	+09
WEDT	TIMEZONE	+01
Western European Daylight Time ::	TIMEZONEFULL	+01
WEST	TIMEZONE	+01
Western European Summer Time ::	TIMEZONEFULL	+01
WET	TIMEZONE
Western European Time ::	TIMEZONEFULL
WST	TIMEZONE	+09
Western Summer Time ::	TIMEZONEFULL	+09
WST	TIMEZONE	+08
Western Standard Time ::	TIMEZONEFULL	+08 
